maze3d = [
    # Layer 0 (z=0)
    [
        [0, 1, 1, 1, 1, 1, 1, 1, 1, 1],  # y=0
        [0, 1, 0, 0, 0, 1, 0, 0, 0, 1],  # y=1
        [0, 0, 0, 0, 0, 0, 0, 1, 0, 1],  # y=2
        [1, 1, 1, 1, 0, 1, 0, 1, 0, 1],  # y=3
        [0, 0, 0, 0, 0, 1, 0, 1, 0, 1],  # y=4
        [0, 1, 1, 1, 1, 1, 0, 1, 0, 1],  # y=5
        [0, 0, 0, 0, 0, 0, 0, 0, 0, 0],  # y=6
        [1, 1, 1, 1, 1, 1, 1, 1, 1, 0],  # y=7
        [0, 0, 0, 0, 0, 0, 0, 0, 0, 0],  # y=8
        [1, 1, 1, 1, 1, 1, 1, 1, 0, 0]   # y=9
    ],
    # Layer 1 (z=1)
    [
        [1, 1, 1, 1, 1, 1, 1, 1, 1, 1],  # y=0
        [0, 1, 0, 0, 0, 1, 0, 0, 0, 1],  # y=1
        [0, 1, 0, 1, 0, 1, 0, 1, 0, 1],  # y=2
        [0, 1, 0, 1, 0, 1, 0, 1, 0, 1],  # y=3
        [0, 1, 0, 1, 0, 1, 0, 1, 0, 1],  # y=4
        [0, 1, 0, 1, 0, 1, 0, 1, 0, 1],  # y=5
        [0, 1, 0, 1, 0, 1, 0, 1, 0, 1],  # y=6
        [0, 1, 0, 1, 0, 1, 0, 1, 0, 1],  # y=7
        [0, 0, 0, 1, 0, 0, 0, 1, 0, 0],  # y=8
        [1, 1, 1, 1, 1, 1, 1, 1, 1, 0]   # y=9
    ],
    # Layer 2 (z=2)
    [
        [1, 1, 1, 1, 1, 1, 1, 1, 1, 1],  # y=0
        [0, 0, 0, 0, 0, 0, 0, 0, 0, 1],  # y=1
        [1, 1, 1, 1, 1, 1, 1, 1, 0, 1],  # y=2
        [0, 0, 0, 0, 0, 0, 0, 0, 0, 1],  # y=3
        [0, 1, 1, 1, 1, 1, 1, 1, 1, 1],  # y=4
        [0, 0, 0, 0, 0, 0, 0, 0, 0, 1],  # y=5
        [1, 1, 1, 1, 1, 1, 1, 1, 0, 1],  # y=6
        [0, 0, 0, 0, 0, 0, 0, 0, 0, 1],  # y=7
        [0, 1, 1, 1, 1, 1, 1, 1, 1, 0],  # y=8
        [1, 1, 1, 1, 1, 1, 1, 1, 1, 0]   # y=9
    ],
    # Layer 3 (z=3)
    [
        [1, 1, 1, 1, 1, 1, 1, 1, 1, 1],  # y=0
        [0, 0, 0, 0, 0, 0, 0, 0, 0, 0],  # y=1
        [1, 1, 1, 1, 1, 1, 1, 1, 1, 1],  # y=2
        [0, 0, 0, 0, 0, 0, 0, 0, 0, 0],  # y=3
        [1, 1, 1, 1, 1, 1, 1, 1, 1, 1],  # y=4
        [0, 0, 0, 0, 0, 0, 0, 0, 0, 0],  # y=5
        [1, 1, 1, 1, 1, 1, 1, 1, 1, 1],  # y=6
        [0, 0, 0, 0, 0, 0, 0, 0, 0, 0],  # y=7
        [1, 1, 1, 1, 1, 1, 1, 1, 1, 0],  # y=8
        [1, 1, 1, 1, 1, 1, 1, 1, 0, 0]   # y=9
    ],
    # Layer 4 (z=4)
    [
        [1, 1, 1, 1, 1, 1, 1, 1, 1, 1],  # y=0
        [1, 0, 0, 0, 0, 0, 0, 0, 0, 1],  # y=1
        [1, 0, 1, 1, 1, 1, 1, 1, 0, 1],  # y=2
        [1, 0, 1, 0, 0, 0, 0, 1, 0, 1],  # y=3
        [1, 0, 1, 0, 1, 1, 0, 1, 0, 1],  # y=4
        [1, 0, 1, 0, 1, 1, 0, 1, 0, 1],  # y=5
        [1, 0, 1, 0, 0, 0, 0, 1, 0, 0],  # y=6
        [1, 0, 1, 1, 1, 1, 1, 1, 0, 1],  # y=7
        [1, 0, 0, 0, 0, 0, 0, 0, 0, 0],  # y=8
        [1, 1, 1, 1, 1, 1, 1, 1, 1, 0]   # y=9
    ],
    # Layer 5 (z=5)
    [
        [1, 1, 0, 1, 1, 0, 1, 1, 1, 1],  # y=0
        [0, 0, 0, 0, 0, 0, 0, 0, 0, 0],  # y=1
        [1, 1, 1, 0, 1, 0, 1, 1, 1, 1],  # y=2
        [0, 0, 0, 0, 0, 0, 0, 0, 0, 0],  # y=3
        [1, 1, 1, 0, 1, 0, 1, 1, 1, 1],  # y=4
        [0, 0, 0, 0, 0, 0, 0, 0, 0, 0],  # y=5
        [1, 1, 0, 1, 1, 0, 1, 1, 1, 1],  # y=6
        [0, 0, 0, 0, 0, 0, 0, 0, 0, 0],  # y=7
        [1, 1, 1, 1, 1, 1, 1, 1, 1, 0],  # y=8
        [1, 1, 1, 1, 1, 1, 1, 1, 1, 0]   # y=9
    ],
    # Layer 6 (z=6)
    [
        [1, 1, 1, 1, 1, 1, 1, 1, 1, 1],  # y=0
        [1, 0, 0, 0, 0, 1, 0, 0, 0, 1],  # y=1
        [1, 0, 1, 1, 0, 1, 0, 1, 0, 1],  # y=2
        [1, 0, 0, 1, 0, 1, 0, 1, 0, 1],  # y=3
        [1, 0, 0, 1, 0, 1, 0, 1, 0, 1],  # y=4
        [1, 1, 0, 1, 0, 1, 0, 1, 0, 1],  # y=5
        [1, 1, 0, 1, 0, 1, 0, 1, 0, 0],  # y=6
        [1, 1, 0, 1, 0, 1, 0, 1, 0, 0],  # y=7
        [1, 1, 0, 0, 0, 1, 0, 0, 0, 1],  # y=8
        [1, 1, 1, 1, 1, 1, 0, 1, 1, 0]   # y=9
    ],
    # Layer 7 (z=7)
    [
        [1, 1, 1, 1, 1, 1, 1, 1, 1, 1],  # y=0
        [1, 0, 0, 0, 0, 0, 0, 0, 0, 1],  # y=1
        [1, 0, 1, 1, 1, 1, 1, 1, 0, 1],  # y=2
        [0, 0, 1, 0, 0, 0, 0, 1, 0, 0],  # y=3
        [1, 0, 1, 0, 1, 1, 0, 1, 0, 1],  # y=4
        [1, 0, 1, 0, 1, 1, 0, 1, 0, 1],  # y=5
        [1, 0, 1, 0, 0, 0, 0, 1, 0, 0],  # y=6
        [1, 0, 1, 1, 1, 1, 1, 1, 0, 1],  # y=7
        [1, 0, 0, 0, 0, 0, 0, 0, 0, 1],  # y=8
        [1, 1, 1, 1, 1, 1, 1, 0, 0, 0]   # y=9
    ],
    # Layer 8 (z=8)
    [
        [1, 1, 1, 1, 1, 1, 1, 1, 1, 1],  # y=0
        [0, 0, 0, 0, 0, 0, 0, 0, 0, 1],  # y=1
        [1, 1, 1, 1, 1, 1, 1, 1, 0, 1],  # y=2
        [0, 0, 0, 0, 0, 0, 0, 0, 0, 0],  # y=3
        [1, 1, 1, 1, 0, 1, 1, 0, 1, 0],  # y=4
        [0, 0, 0, 0, 0, 0, 0, 0, 0, 1],  # y=5
        [1, 1, 0, 1, 0, 1, 0, 1, 0, 1],  # y=6
        [0, 0, 0, 0, 0, 0, 0, 0, 0, 0],  # y=7
        [1, 1, 1, 0, 1, 0, 1, 0, 0, 0],  # y=8
        [1, 0, 0, 1, 1, 1, 1, 1, 0, 0]   # y=9
    ],
    # Layer 9 (z=9)
    [
        [0, 1, 1, 1, 0, 1, 1, 1, 1, 1],  # y=0
        [0, 0, 1, 1, 0, 0, 1, 1, 1, 0],  # y=1
        [1, 0, 1, 0, 1, 0, 1, 1, 1, 0],  # y=2
        [1, 0, 0, 0, 1, 0, 0, 0, 0, 0],  # y=3
        [1, 0, 0, 0, 0, 0, 1, 0, 0, 0],  # y=4
        [1, 1, 1, 0, 0, 1, 1, 0, 1, 0],  # y=5
        [1, 1, 1, 0, 0, 1, 1, 0, 1, 0],  # y=6
        [1, 1, 1, 1, 1, 0, 0, 0, 1, 0],  # y=7
        [0, 1, 1, 0, 1, 0, 1, 0, 0, 0],  # y=8
        [1, 1, 1, 0, 0, 0, 0, 1, 0, 0]   # y=9
    ]
]